{
  "width": 5,
  "height": 5,
  "layout": [
    "#####",
    "#.E.#",
    "#T..#",
    "#.P.#",
    "#####"
  ]
}